1111111111111
10000000000M1
1CCE011111001
1P00110000001
1111111111111