1111111111111
1001000000001
1C1E011111001
1001110000001
1000110000001
1000110000001
1000110000001
1000110000001
1P00110000001
1111111111111