1111111111111
1001000000001
1C0E011111001
1001110000001
1000110000001
100011000M001
1000110000001
1000110000001
1P00110000001
1111111111111