1111111111111
10C10000000C1
1000011111001
1P0E110000001
1111111111111